NO ./textures/wall_1.xpm
SO      ./textures/wall_2.xpm
WE ./textures/wall_3.xpm
EA ./textures/wall_4.xpm

F 184,113,39
C 51,198,227

        1111111111111111111111111
        1100000000110000000111011
        1000000001110000000110001
        1001000000000000000110001
111111111011000001110000000000001
110000000011000001110111111111111
11110111111111011100000010001
11110111111111011101010010001
11000000110101011000000010001
11000000100000001100000000001
11000000000100001101010010001
11000001110101011111011110N0111
11110111 1110101 101111010001
11111111 1111111 111111111111



